p pack
26 23
1 ippp
##########################
########...###############
######.......#######..####
#####.........#####....###
####...........####.....##
####...........###.......#
####...........###.......#
####....................##
##.....................###
#.....................####
##...................#####
####..................####
####..................####
#####................#####
####................######
#####................#####
########............######
########...........#######
#########..........#######
##########........########
#############....#########
###############.##########
##########################
%%%
288 yvBF
#
%%%
