p pack
26 23
1 GiNl
##########################
########...###############
######.......#######..####
#####.........#####....###
####...........####.....##
####...........###.......#
####...........###.......#
####....................##
##.....................###
#.....................####
##...................#####
####..................####
####..................####
#####................#####
####................######
#####................#####
########............######
########...........#######
#########..........#######
##########........########
#############....#########
###############.##########
##########################
%%%
1 VoIg
#....
#####
#....
%%%
3 GWOl
##
%%%
1 wXnx
.##
###
##.
%%%
2 PJuE
##..
.##.
..##
...#
%%%
3 UWtS
#####.
....##
%%%
1 dOKU
#.....
######
%%%
2 NgQG
######
.....#
%%%
2 NnIr
#...
##..
.##.
..##
%%%
1 VkAq
##...
.####
....#
%%%
1 Kdhs
.#
##
#.
%%%
5 BxrI
#######
%%%
4 chMP
###...
..####
%%%
1 muEH
####.
...##
....#
%%%
3 eflZ
####..
...###
%%%
1 CxWw
#...
##..
.###
...#
%%%
7 tDRb
#
%%%
1 fiCz
##...
.##..
..###
%%%
4 JDCj
##....
.#####
%%%
1 hokc
##..
.#..
.##.
..##
%%%
1 UaGN
...#
####
##..
%%%
1 InXF
####.
..###
%%%
1 dUbM
.#..
.###
###.
%%%
1 ULso
##...
.####
...#.
%%%
1 DFqu
#..
###
###
%%%
1 Skaf
####
...#
%%%
