AAAAAAAAAAAAAAAAAAAAAAAAAAAAAAAAAAAAAAAAAAAAAAAAAAAAAAAAAAAAAAAAAAAA
AAAAAAAAAAAAAAAAAAAAAAAAAAAAAAAAAAAAAAAAAAAAAAAAAAAAAAAAAAAAAAAAAAAA
AAAAAAAAAAAAAAAAAAAAAAAAAAAAAAAAAAAAAAAAAAAAAAAAAAAAAAAAAAAAAAAAAAAA
AAAAAAAAAAAAAAAAAAAAAAAAAAAAAAAAAAAAAAAAAAAAAAAAAAAAAAAAAAAAAAAAAAAA
AAAAAAAAAAAAAAAAAAAAAAAAAAAAAAAAAAAAAAAAAAAAAAAAAAAAAAAAAAAAAAAAAAAA
AAAAAAAAAAAAAAAAAAAAAAAAAAAAAAAAAAAAAAAAAAAAAAAAAAAAAAAAAAAAAAAAAAAA
AAAAAAAAAAAAAAAAAAAAAAAAAAAAAAAAAAAAAAAAAAAAAAAAAAAAAAAAAAAAAAAAAAAA
AAAAAAAAAAAAAAAAAAAAAAAAAAAAAAAAAAAAAAAAAAAAAAAAAAAAAAAAAAAAAAAAAAAA
AAAAAAAAAAAAAAAAAAAAAAAAAAAAAAAAAAAAAAAAAAAAAAAAAAAAAAAAAAAAAAAAAAAA
AAAAAAAAAAAAAAAAAAAAAAAAAAAAAAAAAAAAAAAAAAAAAAAAAAAAAAAAAAAAAAAAAAAA
AAAAAAAAAAAAAAAAAAAAAAAAAAAAAAAAAAAAAAAAAAAAAAAAAAAAAAAAAAAAAAAAAAAA
AAAAAAAAAAAAAAAAAAAAAAAAAAAAAAAAAAAAAAAAAAAAAAAAAAAAAAAAAAAAAAAAAAAA
AAAAAAAAAAAAAAAAAAAAAAAAAAAAAAAAAAAAAAAAAAAAAAAAAAAAAAAAAAAAAAAAAAAA
AAAAAAAAAAAAAAAAAAAAAAAAAAAAAAAAAAAAAAAAAAAAAAAAAAAAAAAAAAAAAAAAAAAA
AAAAAAAAAAAAAAAAAAAAAAAAAAAAAAAAAAAAAAAAAAAAAAAAAAAAAAAAAAAAAAAAAAAA
AAAAAAAAAAAAAAAAAAAAAAAAAAAAAAAAAAAAAAAAAAAAAAAAAAAAAAAAAAAAAAAAAAAA
AAAAAAAAAAAAAAAAAAAAAAAAAAAAAAAAAAAAAAAAAAAAAAAAAAAAAAAAAAAAAAAAAAAA
AAAAAAAAAAAAAAAAAAAAAAAAAAAAAAAAAAAAAAAAAAAAAAAAAAAAAAAAAAAAAAAAAAAA
AAAAAAAAAAAAAAAAAAAAAAAAAAAAAAAAAAAAAAAAAAAAAAAAAAAAAAAAAAAAAAAAAAAA
AAAAAAAAAAAAAAAAAAAAAAAAAAAAAAAAAAAAAAAAAAAAAAAAAAAAAAAAAAAAAAAAAAAA
AAAAAAAAAAAAAAAAAAAAAAAAAAAAAAAAAAAAAAAAAAAAAAAAAAAAAAAAAAAAAAAAAAAA
AAAAAAAAAAAAAAAAAAAAAAAAAAAAAAAAAAAAAAAAAAAAAAAAAAAAAAAAAAAAAAAAAAAA
AAAAAAAAAAAAAAAAAAAAAAAAAAAAAAAAAAAAAAAAAAAAAAAAAAAAAAAAAAAAAAAAAAAA
AAAAAAAAAAAAAAAAAAAAAAAAAAAAAAAAAAAAAAAAAAAAAAAAAAAAAAAAAAAAAAAAAAAA
AAAAAAAAAAAAAAAAAAAAAAAAAAAAAAAAAAAAAAAAAAAAAAAAAAAAAAAAAAAAAAAAAAAA
AAAAAAAAAAAAAAAAAAAAAAAAAAAAAAAAAAAAAAAAAAAAAAAAAAAAAAAAAAAAAAAAAAAA
AAAAAAAAAAAAAAAAAAAAAAAAAAAAAAAAAAAAAAAAAAAAAAAAAAAAAAAAAAAAAAAAAAAA
AAAAAAAAAAAAAAAAAAAAAAAAAAAAAAAAAAAAAAAAAAAAAAAAAAAAAAAAAAAAAAAAAAAA
AAAAAAAAAAAAAAAAAAAAAAAAAAAAAAAAAAAAAAAAAAAAAAAAAAAAAAAAAAAAAAAAAAAA
AAAAAAAAAAAAAAAAAAAAAAAAAAAAAAAAAAAAAAAAAAAAAAAAAAAAAAAAAAAAAAAAAAAA
AAAAAAAAAAAAAAAAAAAAAAAAAAAAAAAAAAAAAAAAAAAAAAAAAAAAAAAAAAAAAAAAAAAA
AAAAAAAAAAAAAAAAAAAAAAABBBBBBBBBBBBBBBBBBBBBBBBAAAAAAAAAAAAAAAAAAAAA
AAAAAAAAAAAAAAAAAAAAAAABBBAABBEEEEBAABBBBBBBBBBAAAAAAAAAAAAAAAAAAAAA
AAAAAAAAAAAAAAAAAAAAAAABBBABEEEEEEEBAAAAABFFBABAAAAAAAAAAAAAAAAAAAAA
AAAAAAAAAAAAAAAAAAAAAAABBBBEEEEEEEEEBHHHHBFEBBBAAAAAAAAAAAAAAAAAAAAA
AAAAAAAAAAAAAAAAAAAAAAABBBBEEEEEEEEEBHHHBFEEEEBAAAAAAAAAAAAAAAAAAAAA
AAAAAAAAAAAAAAAAAAAAAAABBBEDEEEEEEEEBHHHBFEEEEBAAAAAAAAAAAAAAAAAAAAA
AAAAAAAAAAAAAAAAAAAAAAABBBEEEEEEEEEEBBBBEEEEEBBAAAAAAAAAAAAAAAAAAAAA
AAAAAAAAAAAAAAAAAAAAAAABBBGEEEEEEEEEFEEEEEEEBIBAAAAAAAAAAAAAAAAAAAAA
AAAAAAAAAAAAAAAAAAAAAAABGGGGGGGGEEEFFFEEEEEBIIBAAAAAAAAAAAAAAAAAAAAA
AAAAAAAAAAAAAAAAAAAAAAABBBCCGGEEEFFFEBBEEEBHIIBAAAAAAAAAAAAAAAAAAAAA
AAAAAAAAAAAAAAAAAAAAAAABBBBEEEFEGBFFFBHBEEEBIIBAAAAAAAAAAAAAAAAAAAAA
AAAAAAAAAAAAAAAAAAAAAAABBBBEEFFFBEFFFFBHBEEBIIBAAAAAAAAAAAAAAAAAAAAA
AAAAAAAAAAAAAAAAAAAAAAABBBBBFFFFFEEFFFFBEEBHIIBAAAAAAAAAAAAAAAAAAAAA
AAAAAAAAAAAAAAAAAAAAAAABBBBEEEFFFEEFFFEEEBHHIIBAAAAAAAAAAAAAAAAAAAAA
AAAAAAAAAAAAAAAAAAAAAAABBBBBBBEEFFEFFFFFEEBHIIBAAAAAAAAAAAAAAAAAAAAA
AAAAAAAAAAAAAAAAAAAAAAABBBBIHHBEEEFFEFFEEBHHIIBAAAAAAAAAAAAAAAAAAAAA
AAAAAAAAAAAAAAAAAAAAAAABBBBIHHBEEEEEFFFFBHHHIIBAAAAAAAAAAAAAAAAAAAAA
AAAAAAAAAAAAAAAAAAAAAAABBBBIHHHBEEFFFFFEBHHHIIBAAAAAAAAAAAAAAAAAAAAA
AAAAAAAAAAAAAAAAAAAAAAABBBBAHHHHBBBFFFFBHHHHAABAAAAAAAAAAAAAAAAAAAAA
AAAAAAAAAAAAAAAAAAAAAAABBBBAHHHHHHHBBFBHHHHHAABAAAAAAAAAAAAAAAAAAAAA
AAAAAAAAAAAAAAAAAAAAAAABBBBBBBBBBBBBBBBBBBBBBBBAAAAAAAAAAAAAAAAAAAAA
AAAAAAAAAAAAAAAAAAAAAAAAAAAAAAAAAAAAAAAAAAAAAAAAAAAAAAAAAAAAAAAAAAAA
AAAAAAAAAAAAAAAAAAAAAAAAAAAAAAAAAAAAAAAAAAAAAAAAAAAAAAAAAAAAAAAAAAAA
AAAAAAAAAAAAAAAAAAAAAAAAAAAAAAAAAAAAAAAAAAAAAAAAAAAAAAAAAAAAAAAAAAAA
AAAAAAAAAAAAAAAAAAAAAAAAAAAAAAAAAAAAAAAAAAAAAAAAAAAAAAAAAAAAAAAAAAAA