p pack
26 23
1 PSML
##########################
########...###############
######.......#######..####
#####.........#####....###
####...........####.....##
####...........###.......#
####...........###.......#
####....................##
##.....................###
#.....................####
##...................#####
####..................####
####..................####
#####................#####
####................######
#####................#####
########............######
########...........#######
#########..........#######
##########........########
#############....#########
###############.##########
##########################
%%%
1 YRTG
#......
##.....
#......
#######
#......
%%%
1 mFLK
##...
.###.
#####
%%%
1 RYxo
..##
.###
.###
####
%%%
1 BqyA
##...
.##..
..##.
...##
.####
%%%
1 EGXj
.##..
..##.
#####
###..
%%%
6 JmkE
#
%%%
1 wgbx
######
######
%%%
5 agtC
#####......
....#######
%%%
1 oKWD
####.......
...########
%%%
1 hOZC
#########
.....###.
%%%
1 VUpS
#####..
....###
..####.
%%%
1 wzXv
.######
#####..
#......
%%%
1 yNZH
###.......
..########
.........#
%%%
1 PgSA
###......
..##...##
...#####.
%%%
1 UueV
#####
.##..
%%%
2 xzRD
#######....
......#####
%%%
3 pcDQ
###
%%%
1 LcKT
.####.
######
##....
%%%
1 lvyQ
######.....
.....######
%%%
1 ipxZ
####.....
...######
......##.
%%%
2 Oymf
##
%%%
