p pack
26 23
1 upaC
##########################
########...###############
######.......#######..####
#####.........#####....###
####...........####.....##
####...........###.......#
####...........###.......#
####....................##
##.....................###
#.....................####
##...................#####
####..................####
####..................####
#####................#####
####................######
#####................#####
########............######
########...........#######
#########..........#######
##########........########
#############....#########
###############.##########
##########################
%%%
8 vCkH
#....
#####
%%%
1 UMEV
##
%%%
5 seKG
##...
.####
%%%
3 yCya
##..
.##.
..##
%%%
3 aCFQ
###.
..##
...#
%%%
2 jMxU
#...
##..
.###
%%%
1 NcdZ
.##
.##
##.
%%%
10 yqye
######
%%%
3 RTpn
###..
..###
%%%
2 oCAF
#####
...#.
%%%
1 zXxL
..##
####
%%%
2 uvGS
####.
...##
%%%
1 tWGk
##..
.###
...#
%%%
5 KTes
#
%%%
2 Qkgb
#####
....#
%%%
1 vGWk
###
###
%%%
1 dKSz
...#.
#####
%%%
1 ZlVC
####
.##.
%%%
1 Ewgo
####
..#.
%%%
