p pack
26 23
1 siPA
##########################
########...###############
######.......#######..####
#####.........#####....###
####...........####.....##
####...........###.......#
####...........###.......#
####....................##
##.....................###
#.....................####
##...................#####
####..................####
####..................####
#####................#####
####................######
#####................#####
########............######
########...........#######
#########..........#######
##########........########
#############....#########
###############.##########
##########################
%%%
1 abNM
#......
#......
#......
#######
%%%
1 nuNL
##...
.###.
#####
%%%
1 soxG
.##.
###.
###.
..##
%%%
11 wjbc
#
%%%
1 zroV
##...
.##..
..##.
...##
...##
%%%
1 AAaI
##..
.##.
..##
####
%%%
1 gNAY
#.......
###.....
..######
%%%
1 fIlp
.#...
###..
#....
#####
%%%
1 UoEc
######
...###
...#..
%%%
3 sewS
##......
.#######
.......#
%%%
1 lxFp
#.......
#######.
......##
%%%
2 mIDs
#####....
....#####
%%%
2 gSOE
####.....
...######
%%%
2 wCed
#####..
....##.
.....##
......#
%%%
1 ykhY
#####
.####
.#...
%%%
2 NusM
###......
..#######
%%%
1 gEup
#........
#########
%%%
1 vVYI
..#...
..###.
######
%%%
1 YWkX
##
%%%
1 Tuos
........#
#########
%%%
1 NILL
##########
%%%
2 pJEs
.......##
########.
%%%
1 fgKR
####
..#.
%%%
