p pack
26 23
1 hLoI
##########################
########...###############
######.......#######..####
#####.........#####....###
####...........####.....##
####...........###.......#
####...........###.......#
####....................##
##.....................###
#.....................####
##...................#####
####..................####
####..................####
#####................#####
####................######
#####................#####
########............######
########...........#######
#########..........#######
##########........########
#############....#########
###############.##########
##########################
%%%
66 uvcV
###
%%%
10 VYWj
#.
##
%%%
16 miZu
##
.#
%%%
1 UtUT
.#
##
%%%
2 Sykf
##
#.
%%%
3 gFrG
#
%%%
