p pack
26 23
1 VFcm
##########################
########...###############
######.......#######..####
#####.........#####....###
####...........####.....##
####...........###.......#
####...........###.......#
####....................##
##.....................###
#.....................####
##...................#####
####..................####
####..................####
#####................#####
####................######
#####................#####
########............######
########...........#######
#########..........#######
##########........########
#############....#########
###############.##########
##########################
%%%
1 lmgy
###
#..
%%%
8 jfox
##.
.##
%%%
29 irzC
####
%%%
4 rhPa
#.
##
.#
%%%
14 YGka
#..
###
%%%
10 iIXd
###
..#
%%%
1 POgr
###
.#.
%%%
6 KDcf
#
%%%
1 jSCs
.#
##
#.
%%%
2 dpJr
.##
##.
%%%
1 IGhF
##
%%%
