p pack
26 23
1 MFtS
##########################
########...###############
######.......#######..####
#####.........#####....###
####...........####.....##
####...........###.......#
####...........###.......#
####....................##
##.....................###
#.....................####
##...................#####
####..................####
####..................####
#####................#####
####................######
#####................#####
########............######
########...........#######
#########..........#######
##########........########
#############....#########
###############.##########
##########################
%%%
4 LKUR
#...
####
%%%
1 hThD
##
%%%
8 ECoh
##..
.###
%%%
5 CgfD
#..
##.
.##
%%%
6 vlXh
##.
.##
..#
%%%
2 IJxu
#.
##
##
%%%
2 Razi
.##
###
%%%
1 TQNY
.#.
.#.
###
%%%
4 pjEz
####
...#
%%%
18 ZkKK
#####
%%%
2 CVGv
###.
..##
%%%
1 PsZH
###
##.
%%%
6 sHNx
#
%%%
1 Ktya
###
.##
%%%
1 hddW
####
..#.
%%%
1 nYtk
..##
###.
%%%
